 0 1 0 0 0 0 0 0 0 0 0 0 0 0 0 0 0 0 0 0 -1 1 0 1 3 0 0 0 0 0 0 2 0 0 -3 -4 0 1 -1 1 0 0 -1
 1 0 0 1 0 0 0 0 0 0 0 0 0 1 -1 0 0 0 0 0 0 -1 0 1 3 0 -1 1 0 0 1 2 -2 -3 -3 0 1 2 -1 0 -1 0 -1
 1 0 0 0 0 1 -1 1 0 0 0 0 0 0 0 0 0 0 1 -1 0 0 -2 1 4 -1 0 0 0 0 3 -1 -4 -3 0 2 1 2 -3 0 -1 0 0
 1 0 0 0 0 1 1 -1 0 0 0 1 0 -1 0 0 1 -1 1 0 -1 -2 -1 2 4 1 0 -1 -1 2 0 -4 -5 0 3 1 0 2 -3 0 0 -1 0
 1 0 0 0 1 0 0 0 0 0 0 1 -1 0 1 -1 0 0 0 0 1 0 -1 -2 2 -1 0 0 0 3 -2 -5 4 -1 0 1 0 1 -1 -1 0 -1 0
 1 0 0 1 0 0 1 -1 1 -1 1 0 0 0 0 0 0 0 0 0 -1 1 1 -2 -4 5 0 0 0 -4 -4 4 2 -2 2 0 0 0 0 0 -1 -1 0
 1 1 -1 1 1 0 0 0 0 0 0 1 0 -1 1 0 -1 0 0 4 -1 -4 1 -1 37 -36 0 1 -1 -5 -3 5 1 -2 2 0 0 -1 1 -1 0 -1 -1
 2 0 1 0 1 0 0 0 1 0 0 0 0 0 0 0 0 0 -1 10 25 -29 -12 45 20 -55 -4 1 -2 -5 -4 6 2 -3 2 0 0 -2 1 1 -1 -1 -1
 1 1 1 0 1 0 0 1 0 0 0 1 0 0 0 -1 0 1 -1 4 11 -15 -8 50 14 -46 -15 6 -4 -7 -2 6 2 -4 3 -1 0 -1 1 -1 0 -1 -1
 2 0 1 1 1 0 0 1 0 1 -1 1 0 1 -1 0 0 0 1 -8 2 4 15 20 12 -7 -40 -2 -3 -6 -3 7 2 -5 3 0 -1 -1 1 0 -1 0 -1
 2 0 1 1 0 1 1 1 0 0 0 0 0 1 -1 0 1 0 -4 -11 4 -5 47 -24 29 6 -10 -14 -28 -1 -7 7 3 -6 4 -1 0 -1 -1 1 -1 -1 0
 2 1 1 1 1 0 1 1 0 0 1 -1 1 0 0 0 -1 2 -15 1 8 -10 30 34 -7 2 -24 8 -39 -3 -6 8 1 -6 4 -1 1 -2 0 -1 0 -1 0
 2 0 0 2 2 2 0 3 -1 -1 0 3 -2 0 -1 0 0 2 -14 -12 29 14 14 14 -5 -7 -9 -10 -19 15 -36 10 1 -7 6 -1 0 -4 3 -1 0 -1 -1
 10 10 -8 -2 0 2 -1 -1 4 0 -5 6 -2 2 2 -4 -3 9 -15 -21 4 15 25 2 1 14 -7 -27 -29 12 -10 0 4 -1 -2 0 1 0 0 1 0 0 0
 1 8 5 -10 -13 10 4 -12 14 -11 23 -21 -3 1 3 -3 4 -6 5 -16 8 -4 12 7 32 4 -3 -39 -25 0 -1 2 3 -4 4 4 -5 -2 0 0 -1 -1 1
 -11 -4 -2 -2 10 3 -7 9 5 -6 0 -4 39 -7 -10 0 -13 -2 15 -11 -18 16 23 16 5 -10 9 -60 -8 -1 -2 5 6 -8 2 2 -1 -1 1 -1 1 -1 -3
 -3 -5 -3 20 -9 22 6 -34 -13 4 36 -19 15 -6 -19 -7 22 -2 20 -3 -25 -6 29 11 16 0 -23 -42 0 1 0 -1 2 1 -1 0 0 1 -2 3 -2 2 1
 -3 6 8 -20 -7 0 0 16 -16 16 33 -29 -2 -8 -1 -2 31 -29 2 6 -15 14 -16 18 31 -31 -3 -2 -12 1 0 0 2 -1 0 0 -1 1 -1 -1 1 0 1
 14 -26 9 4 -12 2 -2 1 16 34 -27 -22 2 1 -3 6 -10 8 6 -1 -13 16 -11 12 -6 -11 9 -3 -5 1 0 0 1 2 -3 0 0 1 -2 0 1 0 1
 -21 6 -3 -5 15 8 -17 19 5 -6 -16 -5 -1 -2 31 -30 -5 10 9 12 -26 -5 7 9 4 -15 8 -11 -1 0 0 0 2 1 -3 1 0 0 -1 1 0 0 1
 -5 0 1 -2 0 8 12 3 -4 -15 -4 0 17 -13 8 -9 0 -3 2 4 -6 2 8 8 5 -17 -3 -3 1 0 0 0 1 1 -2 0 0 1 0 -1 0 1 1
 1 3 -5 5 13 15 10 -26 -7 0 -6 17 1 -16 -6 7 3 10 3 0 -8 -13 9 2 10 -11 -12 1 0 0 0 0 0 0 1 0 -1 1 -1 1 -1 1 1
 5 7 18 -9 13 -8 -10 -8 10 -10 33 -5 -36 10 0 14 20 -30 13 -10 3 -19 8 1 15 -13 -14 1 0 0 0 0 0 0 0 1 -1 1 -1 1 0 0 0
 2 30 -17 2 -13 -11 0 0 0 0 0 0 4 -4 2 -2 0 3 -3 0 0 5 6 3 11 -5 -19 0 0 0 0 0 0 0 0 0 1 0 -1 1 0 0 0
 10 -2 18 -26 -5 0 -4 0 0 0 3 1 -4 0 0 0 0 0 2 8 -4 -3 7 2 18 -10 -14 -6 1 0 0 0 1 0 -1 1 -1 0 0 1 0 1 0
 0 0 -18 -1 0 2 -2 33 41 -34 -39 10 -7 4 -8 0 0 0 2 5 -5 6 8 2 6 -3 -5 -16 1 0 0 0 1 0 -1 0 1 -1 0 0 1 0 0
 -13 -6 1 3 -4 25 23 -21 29 -37 -12 2 1 -1 -2 -5 -2 21 -14 1 -8 4 4 2 9 18 -29 -7 0 0 0 1 0 0 -1 1 -1 1 -1 0 0 1 0