 74 73 73 73 73 73 73 73 73 73 73 73
 74 73 73 76 76 73 73 73 73 73 73 73
 74 73 76 0 0 76 73 73 73 73 73 73
 74 73 76 16 22 24 76 73 73 73 73 73
 74 76 11 29 28 14 76 73 73 73 73 73
 75 76 22 39 43 54 76 74 74 74 74 74
 74 76 33 42 52 50 49 76 76 73 73 73
 74 75 33 41 60 58 50 49 22 76 73 73
 74 76 33 41 61 59 52 53 25 7 76 73
 74 76 34 43 40 53 35 37 28 13 76 73
 75 76 7 40 38 37 27 28 28 7 76 74
 74 73 76 13 19 19 20 20 19 76 73 73
 74 73 73 76 76 76 76 76 76 73 73 73
 74 73 73 74 73 73 73 73 73 73 73 74