 0 -4 0 1 0 0 0 0 0 0 0 0
 0 -5 1 11 0 -10 0 0 0 0 0 0
 0 -4 11 -255 0 255 -10 0 0 -1 1 0
 0 -4 11 -201 18 10 173 -10 0 0 0 0
 -1 8 -219 64 -4 -51 210 -12 1 -1 1 0
 4 4 -178 52 20 31 75 -8 0 0 0 0
 -3 7 -144 36 26 -5 -4 91 0 -10 0 0
 -2 6 -142 33 57 -5 -27 -4 -90 181 -12 0
 1 6 -142 32 59 -6 -22 3 -91 -61 230 -12
 1 6 -141 36 -8 35 -58 6 -30 -49 210 -11
 3 4 -230 108 -6 -2 -34 5 -2 -72 233 -7
 -4 -4 12 -210 19 0 3 -1 -3 192 -11 0
 1 -5 1 11 0 0 0 0 0 -10 0 0
 0 -4 0 2 -1 0 0 0 0 0 0 1