 248 244 244 245 245 245 245 245 245 245 245 245
 248 243 244 255 255 245 245 245 245 245 245 245
 248 244 255 0 0 255 245 245 245 244 245 245
 248 244 255 54 72 82 255 245 245 245 245 245
 247 255 36 100 96 45 255 243 244 243 244 244
 251 255 77 129 149 180 255 247 247 247 247 247
 248 255 111 147 173 168 164 255 255 245 245 245
 246 252 110 143 200 195 168 164 74 255 243 243
 247 253 111 143 202 196 174 177 86 25 255 243
 248 254 113 149 141 176 118 124 94 45 255 244
 251 255 25 133 127 125 91 96 94 22 255 248
 247 243 255 45 64 64 67 66 63 255 244 244
 248 243 244 255 255 255 255 255 255 245 245 245
 248 244 244 246 245 245 245 245 245 245 245 246